[{"name" : "map1", "map" : 

[
    ["C", "B", "B", "B", "B", "B", "B", "B", "B", "B", "B", "B", "B", "B", "B", "B", "B", "B", "B", "B", "B", "B", "B", "B", "B", "B", "B", "B", "B", "B", "B", "D"],
    ["A", "V", "V", "V", "V", "V", "V", "V", "V", "V", "V", "V", "V", "V", "V", "V", "V", "V", "V", "V", "V", "V", "V", "V", "V", "V", "V", "V", "V", "V", "V", "A"],
    ["A", "V", "V", "V", "V", "V", "V", "V", "V", "V", "V", "V", "V", "V", "V", "V", "V", "V", "V", "V", "V", "V", "V", "V", "V", "V", "V", "V", "V", "V", "V", "A"],
    ["A", "V", "V", "V", "V", "V", "V", "V", "V", "V", "V", "V", "V", "V", "V", "V", "V", "V", "V", "V", "V", "V", "V", "V", "V", "V", "V", "V", "V", "V", "V", "A"],
    ["A", "V", "V", "V", "V", "V", "V", "V", "V", "V", "V", "V", "V", "V", "V", "V", "V", "V", "V", "V", "V", "V", "V", "V", "V", "V", "V", "V", "V", "V", "V", "A"],
    ["A", "V", "V", "V", "V", "V", "V", "V", "V", "V", "V", "V", "V", "V", "V", "V", "V", "V", "V", "V", "V", "V", "V", "V", "V", "V", "V", "V", "V", "V", "V", "A"],
    ["A", "V", "V", "V", "V", "V", "V", "V", "V", "V", "V", "V", "V", "V", "V", "V", "V", "V", "V", "V", "V", "V", "V", "V", "V", "V", "V", "V", "V", "V", "V", "A"],
    ["A", "V", "V", "V", "V", "V", "V", "V", "V", "V", "V", "V", "V", "V", "V", "V", "V", "V", "V", "V", "V", "V", "V", "V", "V", "V", "V", "V", "V", "V", "V", "A"],
    ["A", "V", "V", "V", "V", "V", "V", "V", "V", "V", "V", "V", "V", "V", "V", "V", "V", "A", "V", "V", "B", "B", "B", "V", "V", "V", "V", "V", "V", "V", "V", "A"],
    ["A", "V", "V", "V", "V", "V", "V", "V", "V", "V", "V", "V", "C", "B", "D", "V", "B", "G", "B", "V", "V", "V", "V", "V", "V", "V", "V", "V", "V", "V", "V", "A"],
    ["A", "V", "V", "V", "V", "V", "V", "V", "V", "V", "V", "V", "A", "V", "A", "V", "V", "A", "V", "V", "B", "B", "B", "V", "V", "V", "V", "V", "V", "V", "V", "A"],
    ["A", "V", "V", "V", "V", "V", "V", "V", "V", "V", "V", "V", "E", "B", "F", "V", "V", "V", "V", "V", "V", "V", "V", "V", "V", "V", "V", "V", "V", "V", "V", "A"],
    ["A", "V", "V", "V", "V", "V", "V", "V", "V", "V", "V", "V", "V", "V", "V", "V", "V", "V", "V", "V", "V", "V", "V", "V", "V", "V", "V", "V", "V", "V", "V", "A"],
    ["A", "V", "V", "V", "V", "V", "A", "C", "B", "V", "V", "V", "V", "V", "V", "V", "V", "V", "V", "V", "V", "V", "V", "V", "V", "V", "V", "V", "V", "V", "V", "A"],
    ["A", "V", "V", "V", "V", "V", "E", "G", "B", "D", "V", "V", "V", "V", "V", "V", "V", "V", "V", "V", "V", "V", "V", "V", "V", "V", "V", "V", "V", "V", "V", "A"],
    ["A", "V", "V", "V", "V", "V", "V", "A", "V", "I", "D", "V", "V", "V", "V", "V", "V", "V", "V", "V", "V", "V", "V", "V", "V", "V", "V", "V", "V", "V", "V", "A"],
    ["A", "V", "V", "V", "V", "V", "V", "V", "B", "J", "A", "V", "V", "V", "V", "V", "V", "V", "V", "V", "V", "V", "V", "V", "V", "V", "V", "V", "V", "V", "V", "A"],
    ["A", "V", "V", "V", "V", "C", "B", "B", "B", "B", "F", "V", "V", "V", "V", "V", "V", "V", "V", "V", "V", "V", "V", "V", "V", "V", "V", "V", "V", "V", "V", "A"],
    ["A", "V", "V", "V", "V", "A", "V", "V", "V", "V", "V", "V", "V", "V", "V", "V", "V", "V", "V", "V", "V", "V", "V", "V", "V", "V", "V", "V", "V", "V", "V", "A"],
    ["A", "V", "V", "V", "V", "A", "V", "V", "V", "V", "A", "T", "B", "V", "V", "V", "V", "V", "V", "V", "V", "V", "V", "V", "V", "V", "V", "V", "V", "V", "V", "A"],
    ["A", "V", "V", "V", "V", "E", "B", "B", "B", "B", "H", "A", "V", "V", "V", "V", "V", "V", "V", "V", "V", "V", "V", "V", "V", "V", "V", "V", "V", "V", "V", "A"],
    ["A", "V", "V", "V", "V", "V", "V", "V", "V", "V", "E", "F", "V", "V", "V", "V", "V", "V", "V", "V", "V", "V", "V", "V", "V", "V", "V", "V", "V", "V", "V", "A"],
    ["A", "V", "V", "V", "V", "V", "V", "V", "V", "V", "V", "V", "V", "V", "V", "V", "V", "V", "V", "V", "V", "V", "V", "V", "V", "V", "V", "V", "V", "V", "V", "A"],
    ["A", "V", "V", "V", "V", "V", "V", "V", "V", "V", "V", "V", "V", "V", "V", "V", "V", "V", "V", "V", "V", "V", "V", "V", "V", "V", "V", "V", "V", "V", "V", "A"],
    ["A", "V", "V", "V", "V", "V", "V", "V", "V", "V", "V", "V", "V", "V", "V", "V", "V", "V", "V", "V", "V", "V", "V", "V", "V", "V", "V", "V", "V", "V", "V", "A"],
    ["E", "B", "B", "B", "B", "B", "B", "B", "B", "B", "B", "B", "B", "B", "B", "B", "B", "B", "B", "B", "B", "B", "B", "B", "B", "B", "B", "B", "B", "B", "B", "F"]

]

},{"name" : "map2", "map" : 

[
    ["M", "M", "V", "E", "E", "M", "E", "M", "E", "V", "E", "M", "E", "V", "M", "E", "E", "M", "E", "V", "V", "E", "V", "E", "V", "M", "M", "M", "E", "M", "M", "M"],
    ["V", "E", "M", "M", "M", "E", "V", "E", "M", "V", "V", "V", "V", "V", "V", "E", "V", "V", "M", "E", "V", "V", "V", "E", "E", "V", "V", "M", "M", "V", "E", "E"],
    ["E", "M", "M", "E", "V", "E", "V", "V", "M", "E", "E", "M", "V", "V", "V", "E", "V", "E", "V", "V", "M", "M", "E", "M", "M", "V", "V", "V", "E", "M", "E", "E"],
    ["V", "E", "M", "M", "V", "E", "M", "M", "E", "M", "E", "M", "E", "E", "V", "M", "M", "M", "M", "E", "E", "M", "E", "E", "E", "E", "V", "V", "M", "M", "M", "M"],
    ["V", "V", "V", "E", "E", "E", "V", "V", "M", "M", "M", "M", "V", "M", "M", "E", "V", "E", "M", "M", "V", "E", "M", "M", "V", "M", "M", "M", "E", "M", "V", "E"],
    ["E", "E", "V", "V", "E", "M", "V", "M", "E", "M", "V", "M", "E", "M", "V", "V", "E", "V", "M", "V", "E", "V", "M", "M", "E", "E", "V", "M", "M", "E", "V", "M"],
    ["M", "V", "E", "V", "E", "M", "V", "M", "M", "E", "M", "M", "V", "E", "M", "E", "M", "V", "M", "E", "E", "V", "V", "E", "E", "M", "E", "V", "V", "E", "M", "M"],
    ["E", "E", "E", "E", "E", "M", "E", "V", "M", "M", "E", "V", "M", "E", "E", "V", "V", "M", "E", "E", "E", "V", "M", "M", "V", "M", "V", "E", "E", "M", "M", "V"],
    ["E", "V", "E", "V", "M", "V", "E", "V", "V", "V", "M", "M", "E", "V", "V", "E", "M", "E", "E", "V", "M", "E", "M", "M", "E", "V", "E", "V", "E", "E", "V", "V"],
    ["M", "V", "E", "M", "M", "V", "E", "M", "M", "M", "E", "V", "V", "M", "V", "V", "V", "M", "M", "V", "M", "M", "E", "M", "E", "E", "M", "M", "M", "E", "E", "M"],
    ["M", "V", "E", "E", "E", "M", "M", "E", "V", "M", "V", "E", "E", "M", "M", "M", "V", "V", "M", "V", "E", "E", "V", "E", "M", "V", "M", "V", "V", "V", "M", "M"],
    ["V", "M", "V", "V", "V", "M", "E", "V", "M", "E", "M", "M", "M", "M", "V", "V", "E", "M", "V", "M", "E", "V", "M", "V", "V", "E", "E", "M", "E", "V", "E", "V"],
    ["E", "M", "E", "E", "E", "E", "E", "M", "E", "M", "M", "V", "V", "M", "V", "V", "M", "V", "M", "E", "M", "M", "V", "V", "E", "M", "V", "E", "M", "E", "E", "E"],
    ["V", "M", "E", "M", "E", "M", "M", "M", "E", "M", "E", "V", "E", "V", "M", "E", "V", "E", "V", "V", "V", "V", "E", "M", "E", "M", "V", "M", "V", "M", "E", "M"],
    ["M", "E", "V", "V", "E", "E", "E", "V", "E", "V", "M", "E", "V", "E", "V", "E", "M", "V", "V", "E", "V", "M", "E", "V", "M", "E", "M", "V", "E", "M", "M", "M"],
    ["E", "V", "E", "E", "E", "V", "E", "M", "V", "E", "V", "E", "V", "M", "E", "E", "E", "E", "M", "E", "V", "E", "V", "E", "V", "V", "V", "V", "E", "V", "E", "E"],
    ["V", "E", "M", "M", "E", "V", "V", "E", "M", "V", "E", "E", "V", "V", "V", "E", "V", "M", "M", "E", "M", "E", "V", "V", "V", "V", "V", "M", "M", "M", "V", "V"],
    ["M", "E", "V", "V", "V", "V", "M", "E", "E", "M", "V", "V", "M", "E", "E", "E", "M", "E", "V", "M", "V", "M", "V", "V", "M", "E", "M", "E", "V", "E", "M", "M"],
    ["V", "M", "E", "V", "V", "V", "V", "E", "M", "V", "M", "E", "M", "V", "M", "M", "V", "E", "E", "M", "E", "V", "E", "M", "V", "V", "M", "V", "M", "V", "M", "E"],
    ["V", "M", "E", "V", "M", "E", "E", "M", "V", "V", "M", "M", "V", "V", "M", "M", "V", "V", "M", "M", "M", "E", "M", "V", "E", "V", "V", "M", "M", "E", "E", "V"],
    ["V", "E", "V", "M", "V", "V", "V", "V", "V", "V", "V", "M", "M", "M", "E", "M", "M", "V", "V", "V", "M", "E", "M", "E", "V", "M", "V", "M", "E", "E", "V", "E"],
    ["M", "M", "M", "M", "E", "M", "M", "V", "V", "M", "E", "M", "V", "M", "M", "E", "M", "E", "E", "M", "E", "V", "E", "V", "V", "E", "M", "E", "M", "M", "E", "V"],
    ["V", "E", "E", "E", "E", "V", "E", "E", "V", "M", "E", "V", "V", "E", "E", "E", "M", "V", "M", "E", "V", "V", "E", "E", "V", "V", "E", "V", "E", "M", "V", "M"],
    ["M", "M", "M", "V", "V", "M", "M", "E", "E", "E", "E", "E", "E", "V", "E", "V", "V", "M", "M", "M", "V", "M", "V", "E", "M", "E", "M", "M", "V", "E", "M", "M"],
    ["V", "V", "V", "E", "V", "E", "M", "E", "E", "V", "V", "V", "M", "V", "E", "E", "E", "V", "E", "V", "M", "M", "E", "V", "E", "M", "V", "M", "E", "M", "E", "V"],
    ["V", "M", "V", "V", "E", "M", "V", "M", "E", "V", "V", "E", "V", "M", "M", "E", "V", "E", "M", "M", "V", "M", "M", "E", "E", "M", "V", "V", "E", "V", "V", "V"],
    ["E", "V", "V", "M", "E", "E", "E", "V", "M", "E", "M", "M", "E", "V", "M", "M", "M", "E", "M", "E", "M", "E", "M", "V", "V", "M", "V", "E", "M", "E", "V", "E"],
    ["M", "V", "E", "V", "E", "V", "V", "V", "E", "E", "V", "V", "M", "V", "V", "M", "E", "E", "V", "M", "E", "V", "E", "M", "E", "M", "E", "M", "E", "M", "M", "E"],
    ["M", "V", "M", "V", "V", "E", "M", "M", "V", "M", "M", "E", "V", "V", "E", "E", "V", "V", "V", "M", "E", "E", "V", "E", "V", "E", "E", "M", "M", "V", "V", "E"],
    ["M", "V", "V", "M", "M", "V", "M", "E", "V", "M", "M", "V", "V", "M", "E", "M", "M", "E", "V", "E", "E", "M", "V", "E", "M", "E", "E", "E", "E", "V", "M", "M"],
    ["E", "M", "V", "M", "E", "E", "M", "M", "M", "M", "E", "V", "V", "E", "V", "V", "E", "M", "E", "M", "M", "V", "V", "V", "V", "M", "E", "M", "E", "V", "M", "M"],
    ["E", "E", "E", "V", "M", "M", "M", "E", "M", "E", "M", "V", "M", "E", "M", "M", "E", "E", "E", "M", "M", "E", "M", "E", "V", "V", "V", "M", "E", "E", "E", "E"]


]
},


{
    "name":"map3",
    "map":[

        ["C", "B", "B", "B", "B", "B", "B", "B", "B", "B", "B", "B", "B", "B", "B", "B", "B", "B", "B", "B", "B", "B", "B", "B", "B", "B", "B", "B", "B", "B", "B", "D"],
        ["A", "V", "V", "V", "V", "V", "V", "V", "V", "V", "V", "V", "V", "V", "V", "V", "V", "V", "V", "V", "V", "V", "V", "V", "V", "V", "V", "V", "V", "V", "V", "A"],
        ["A", "V", "C", "C", "C", "C", "C", "V", "V", "V", "G", "G", "G", "G", "G", "V", "V", "V", "D", "D", "D", "D", "D", "V", "V", "V", "V", "V", "V", "V", "V", "A"],
        ["A", "V", "C", "V", "V", "V", "V", "V", "V", "V", "G", "V", "V", "V", "G", "V", "V", "V", "V", "V", "V", "V", "D", "V", "V", "V", "V", "V", "V", "V", "V", "A"],
        ["A", "V", "C", "V", "V", "V", "V", "V", "V", "V", "G", "G", "G", "G", "G", "V", "V", "V", "V", "V", "V", "V", "D", "V", "V", "V", "V", "V", "V", "V", "V", "A"],
        ["A", "V", "C", "V", "V", "V", "V", "V", "V", "V", "G", "V", "V", "V", "G", "V", "V", "V", "V", "V", "V", "V", "D", "V", "V", "V", "V", "V", "V", "V", "V", "A"],
        ["A", "V", "C", "C", "C", "C", "C", "V", "V", "V", "G", "V", "V", "V", "G", "V", "V", "V", "D", "D", "D", "D", "D", "V", "V", "V", "V", "V", "V", "V", "V", "A"],
        ["A", "V", "V", "V", "V", "V", "V", "V", "V", "V", "V", "V", "V", "V", "V", "V", "V", "V", "V", "V", "V", "V", "V", "V", "V", "V", "V", "V", "V", "V", "V", "A"],
        ["A", "V", "V", "F", "F", "F", "F", "F", "V", "V", "V", "V", "V", "V", "V", "V", "V", "A", "V", "V", "B", "B", "B", "V", "E", "E", "E", "E", "V", "V", "V", "A"],
        ["A", "V", "V", "F", "V", "V", "V", "V", "V", "V", "V", "V", "C", "B", "D", "V", "B", "G", "B", "V", "V", "V", "V", "V", "E", "V", "V", "V", "V", "V", "V", "A"],
        ["A", "V", "V", "F", "V", "V", "V", "V", "V", "V", "V", "V", "A", "V", "A", "V", "V", "A", "V", "V", "B", "B", "B", "V", "E", "V", "V", "V", "V", "V", "V", "A"],
        ["A", "V", "V", "F", "F", "F", "F", "F", "V", "V", "V", "V", "E", "B", "F", "V", "V", "V", "V", "V", "V", "V", "V", "V", "E", "E", "E", "E", "V", "V", "V", "A"],
        ["A", "V", "V", "V", "V", "V", "V", "V", "V", "V", "V", "V", "V", "V", "V", "V", "V", "V", "V", "V", "V", "V", "V", "V", "V", "V", "V", "V", "V", "V", "V", "A"],
        ["A", "V", "V", "V", "V", "V", "V", "V", "V", "V", "V", "V", "V", "V", "V", "V", "V", "V", "V", "V", "V", "V", "V", "V", "V", "V", "V", "V", "V", "V", "V", "A"],
        ["A", "V", "C", "C", "C", "C", "C", "V", "V", "V", "G", "G", "G", "G", "G", "V", "V", "V", "D", "D", "D", "D", "D", "V", "V", "V", "V", "V", "V", "V", "V", "A"],
        ["A", "V", "C", "V", "V", "V", "V", "V", "V", "V", "G", "V", "V", "V", "G", "V", "V", "V", "V", "V", "V", "V", "D", "V", "V", "V", "V", "V", "V", "V", "V", "A"],
        ["A", "V", "C", "V", "V", "V", "V", "V", "V", "V", "G", "G", "G", "G", "G", "V", "V", "V", "V", "V", "V", "V", "D", "V", "V", "V", "V", "V", "V", "V", "V", "A"],
        ["A", "V", "C", "V", "V", "V", "V", "V", "V", "V", "G", "V", "V", "V", "G", "V", "V", "V", "V", "V", "V", "V", "D", "V", "V", "V", "V", "V", "V", "V", "V", "A"],
        ["A", "V", "C", "C", "C", "C", "C", "V", "V", "V", "G", "V", "V", "V", "G", "V", "V", "V", "D", "D", "D", "D", "D", "V", "V", "V", "V", "V", "V", "V", "V", "A"],
        ["A", "V", "V", "V", "V", "V", "V", "V", "V", "V", "V", "V", "V", "V", "V", "V", "V", "V", "V", "V", "V", "V", "V", "V", "V", "V", "V", "V", "V", "V", "V", "A"],
        ["A", "V", "V", "F", "F", "F", "F", "F", "V", "V", "V", "V", "V", "V", "V", "V", "V", "V", "V", "V", "V", "V", "V", "V", "E", "E", "E", "E", "V", "V", "V", "A"],
        ["A", "V", "V", "F", "V", "V", "V", "V", "V", "V", "V", "V", "V", "V", "V", "V", "V", "V", "V", "V", "V", "V", "V", "V", "E", "V", "V", "V", "V", "V", "V", "A"],
        ["A", "V", "V", "F", "V", "V", "V", "V", "V", "V", "V", "V", "V", "V", "V", "V", "V", "V", "V", "V", "V", "V", "V", "V", "E", "V", "V", "V", "V", "V", "V", "A"],
        ["A", "V", "V", "F", "F", "F", "F", "F", "V", "V", "V", "V", "V", "V", "V", "V", "V", "V", "V", "V", "V", "V", "V", "V", "E", "E", "E", "E", "V", "V", "V", "A"],
        ["A", "V", "V", "V", "P", "V", "V", "V", "V", "G", "G", "G", "V", "V", "V", "V", "V", "V", "V", "V", "V", "V", "V", "V", "V", "V", "V", "V", "V", "V", "V", "A"],
        ["E", "B", "B", "B", "B", "B", "B", "B", "B", "B", "B", "B", "B", "B", "B", "B", "B", "B", "B", "B", "B", "B", "B", "B", "B", "B", "B", "B", "B", "B", "B", "F"]
    
    ]
},

{
    "name":"mapVide",
    "map":[

        ["C", "B", "B", "B", "B", "B", "B", "B", "B", "B", "B", "B", "B", "B", "B", "B", "B", "B", "B", "B", "B", "B", "B", "B", "B", "B", "B", "B", "B", "B", "B", "D"],
        ["A", "V", "V", "V", "V", "V", "V", "V", "V", "V", "V", "V", "V", "V", "V", "V", "V", "V", "V", "V", "V", "V", "V", "V", "V", "V", "V", "V", "V", "V", "V", "A"],
        ["A", "V", "V", "V", "V", "V", "V", "V", "V", "V", "V", "V", "V", "V", "V", "V", "V", "V", "V", "V", "V", "V", "V", "V", "V", "V", "V", "V", "V", "V", "V", "A"],
        ["A", "V", "V", "V", "V", "V", "V", "V", "V", "V", "V", "V", "V", "V", "V", "V", "V", "V", "V", "V", "V", "V", "V", "V", "V", "V", "V", "V", "V", "V", "V", "A"],
        ["A", "V", "V", "V", "V", "V", "V", "V", "V", "V", "V", "V", "V", "V", "V", "V", "V", "V", "V", "V", "V", "V", "V", "V", "V", "V", "V", "V", "V", "V", "V", "A"],
        ["A", "V", "V", "V", "V", "V", "V", "V", "V", "V", "V", "V", "V", "V", "V", "V", "V", "V", "V", "V", "V", "V", "V", "V", "V", "V", "V", "V", "V", "V", "V", "A"],
        ["A", "V", "V", "V", "V", "V", "V", "V", "V", "V", "V", "V", "V", "V", "V", "V", "V", "V", "V", "V", "V", "V", "V", "V", "V", "V", "V", "V", "V", "V", "V", "A"],
        ["A", "V", "V", "V", "V", "V", "V", "V", "V", "V", "V", "V", "V", "V", "V", "V", "V", "V", "V", "V", "V", "V", "V", "V", "V", "V", "V", "V", "V", "V", "V", "A"],
        ["A", "V", "V", "V", "V", "V", "V", "V", "V", "V", "V", "V", "V", "V", "V", "V", "V", "A", "V", "V", "B", "B", "B", "V", "V", "V", "V", "V", "V", "V", "V", "A"],
        ["A", "V", "V", "V", "V", "V", "V", "V", "V", "V", "V", "V", "C", "B", "D", "V", "B", "G", "B", "V", "V", "V", "V", "V", "V", "V", "V", "V", "V", "V", "V", "A"],
        ["A", "V", "V", "V", "V", "V", "V", "V", "V", "V", "V", "V", "A", "V", "A", "V", "V", "A", "V", "V", "B", "B", "B", "V", "V", "V", "V", "V", "V", "V", "V", "A"],
        ["A", "V", "V", "V", "V", "V", "V", "V", "V", "V", "V", "V", "E", "B", "F", "V", "V", "V", "V", "V", "V", "V", "V", "V", "V", "V", "V", "V", "V", "V", "V", "A"],
        ["A", "V", "V", "V", "V", "V", "V", "V", "V", "V", "V", "V", "V", "V", "V", "V", "V", "V", "V", "V", "V", "V", "V", "V", "V", "V", "V", "V", "V", "V", "V", "A"],
        ["A", "V", "V", "V", "V", "V", "V", "V", "V", "V", "V", "V", "V", "V", "V", "V", "V", "V", "V", "V", "V", "V", "V", "V", "V", "V", "V", "V", "V", "V", "V", "A"],
        ["A", "V", "V", "V", "V", "V", "V", "V", "V", "V", "V", "V", "V", "V", "V", "V", "V", "V", "V", "V", "V", "V", "V", "V", "V", "V", "V", "V", "V", "V", "V", "A"],
        ["A", "V", "V", "V", "V", "V", "V", "V", "V", "V", "V", "V", "V", "V", "V", "V", "V", "V", "V", "V", "V", "V", "V", "V", "V", "V", "V", "V", "V", "V", "V", "A"],
        ["A", "V", "V", "V", "V", "V", "V", "V", "V", "V", "V", "V", "V", "V", "V", "V", "V", "V", "V", "V", "V", "V", "V", "V", "V", "V", "V", "V", "V", "V", "V", "A"],
        ["A", "V", "V", "V", "V", "V", "V", "V", "V", "V", "V", "V", "V", "V", "V", "V", "V", "V", "V", "V", "V", "V", "V", "V", "V", "V", "V", "V", "V", "V", "V", "A"],
        ["A", "V", "V", "V", "V", "V", "V", "V", "V", "V", "V", "V", "V", "V", "V", "V", "V", "V", "V", "V", "V", "V", "V", "V", "V", "V", "V", "V", "V", "V", "V", "A"],
        ["A", "V", "V", "V", "V", "V", "V", "V", "V", "V", "V", "V", "V", "V", "V", "V", "V", "V", "V", "V", "V", "V", "V", "V", "V", "V", "V", "V", "V", "V", "V", "A"],
        ["A", "V", "V", "B", "B", "B", "B", "B", "V", "V", "V", "V", "V", "V", "V", "V", "V", "V", "V", "V", "V", "V", "V", "V", "V", "V", "V", "V", "V", "V", "V", "A"],
        ["A", "V", "V", "A", "V", "V", "V", "V", "V", "V", "V", "V", "V", "V", "V", "V", "V", "V", "V", "V", "V", "V", "V", "V", "V", "V", "V", "V", "V", "V", "V", "A"],
        ["A", "V", "V", "A", "V", "V", "V", "V", "V", "V", "V", "V", "V", "V", "V", "V", "V", "V", "V", "V", "V", "V", "V", "V", "V", "V", "V", "V", "V", "V", "V", "A"],
        ["A", "V", "V", "A", "F", "F", "F", "F", "V", "V", "V", "V", "V", "V", "V", "V", "V", "V", "V", "V", "V", "V", "V", "V", "V", "V", "V", "V", "V", "V", "V", "A"],
        ["A", "V", "V", "V", "P", "V", "V", "V", "V", "V", "V", "V", "V", "V", "V", "V", "V", "V", "V", "V", "V", "V", "V", "V", "V", "V", "V", "V", "V", "V", "V", "A"],
        ["E", "B", "B", "B", "B", "B", "B", "B", "B", "B", "B", "B", "B", "B", "B", "B", "B", "B", "B", "B", "B", "B", "B", "B", "B", "B", "B", "B", "B", "B", "B", "F"]
    
    ]
},{"name":"Map4", "map":[
    
    ["C", "B", "B", "B", "B", "B", "B", "B", "B", "B", "B", "B", "B", "B", "B", "B", "B", "B", "B", "B", "B", "B", "B", "B", "B", "B", "B", "B", "B", "B", "B", "D"],
    ["A", "V", "V", "V", "V", "V", "V", "V", "V", "V", "V", "V", "V", "V", "V", "V", "V", "V", "V", "V", "V", "V", "V", "V", "V", "V", "V", "V", "V", "V", "V", "A"],
    ["A", "V", "V", "V", "V", "V", "V", "V", "V", "V", "V", "V", "V", "V", "V", "V", "V", "V", "V", "V", "V", "V", "V", "V", "V", "V", "V", "V", "V", "V", "V", "A"],
    ["A", "V", "V", "V", "V", "V", "V", "V", "V", "V", "V", "V", "V", "V", "V", "V", "V", "V", "V", "V", "V", "V", "V", "V", "V", "V", "V", "V", "V", "V", "V", "A"],
    ["A", "V", "V", "V", "V", "V", "V", "V", "V", "V", "V", "V", "V", "V", "V", "V", "V", "V", "V", "V", "V", "V", "V", "V", "V", "V", "V", "V", "V", "V", "V", "A"],
    ["A", "V", "V", "V", "V", "V", "V", "V", "V", "V", "V", "V", "V", "V", "V", "V", "V", "V", "V", "V", "V", "V", "V", "V", "V", "V", "V", "V", "V", "V", "V", "A"],
    ["A", "V", "V", "V", "V", "V", "V", "V", "V", "V", "V", "V", "V", "V", "V", "V", "V", "V", "V", "V", "V", "V", "V", "V", "V", "V", "V", "V", "V", "V", "V", "A"],
    ["A", "V", "V", "V", "V", "V", "V", "V", "V", "V", "V", "V", "V", "V", "V", "V", "V", "V", "V", "V", "V", "V", "V", "V", "V", "V", "V", "V", "V", "V", "V", "A"],
    ["A", "V", "V", "V", "V", "V", "V", "V", "V", "V", "V", "V", "V", "V", "V", "V", "V", "A", "V", "V", "B", "B", "B", "V", "V", "V", "V", "V", "V", "V", "V", "A"],
    ["A", "V", "V", "V", "V", "V", "V", "V", "V", "V", "V", "V", "C", "B", "D", "V", "B", "G", "B", "V", "V", "V", "V", "V", "V", "V", "V", "V", "V", "V", "V", "A"],
    ["A", "V", "V", "A", "V", "C", "B", "B", "V", "V", "V", "V", "A", "V", "A", "V", "V", "A", "V", "V", "B", "B", "B", "V", "V", "V", "V", "V", "V", "V", "V", "A"],
    ["A", "V", "V", "A", "V", "A", "V", "V", "V", "V", "V", "V", "E", "B", "F", "V", "V", "V", "V", "V", "V", "V", "V", "V", "V", "V", "V", "V", "V", "V", "V", "A"],
    ["A", "V", "V", "E", "B", "G", "B", "B", "D", "V", "V", "V", "V", "V", "V", "V", "V", "V", "V", "V", "V", "V", "V", "V", "V", "V", "V", "V", "V", "V", "V", "A"],
    ["A", "V", "V", "V", "V", "A", "V", "V", "A", "V", "V", "V", "V", "V", "V", "V", "V", "V", "V", "V", "V", "V", "V", "V", "V", "V", "V", "V", "V", "V", "V", "A"],
    ["A", "V", "V", "V", "V", "V", "V", "V", "I", "B", "D", "V", "V", "V", "V", "V", "V", "V", "V", "V", "V", "V", "V", "V", "V", "V", "V", "V", "V", "V", "V", "A"],
    ["A", "V", "V", "V", "V", "V", "V", "B", "J", "V", "A", "V", "V", "V", "V", "V", "V", "V", "V", "V", "V", "V", "V", "V", "V", "V", "V", "V", "V", "V", "V", "A"],
    ["A", "V", "V", "V", "V", "V", "V", "V", "V", "V", "A", "V", "V", "V", "V", "V", "V", "V", "V", "V", "V", "V", "V", "V", "V", "V", "V", "V", "V", "V", "V", "A"],
    ["A", "V", "V", "V", "V", "C", "B", "B", "B", "B", "F", "V", "V", "V", "V", "V", "V", "V", "V", "V", "V", "V", "V", "V", "V", "V", "V", "V", "V", "V", "V", "A"],
    ["A", "V", "V", "V", "V", "A", "V", "V", "V", "V", "V", "V", "V", "V", "V", "V", "V", "V", "V", "V", "V", "V", "V", "V", "V", "V", "V", "V", "V", "V", "V", "A"],
    ["A", "V", "V", "V", "V", "A", "V", "V", "V", "V", "A", "T", "B", "V", "V", "V", "V", "V", "V", "V", "V", "V", "V", "V", "V", "V", "V", "V", "V", "V", "V", "A"],
    ["A", "V", "V", "V", "V", "E", "B", "B", "B", "B", "H", "A", "V", "V", "V", "V", "V", "V", "V", "V", "V", "V", "V", "V", "V", "V", "V", "V", "V", "V", "V", "A"],
    ["A", "V", "V", "V", "V", "V", "V", "V", "V", "V", "E", "F", "V", "V", "V", "V", "V", "V", "V", "V", "V", "V", "V", "V", "V", "V", "V", "V", "V", "V", "V", "A"],
    ["A", "V", "V", "V", "V", "V", "V", "V", "V", "V", "V", "V", "V", "V", "V", "V", "V", "V", "V", "V", "V", "V", "V", "V", "V", "V", "V", "V", "V", "V", "V", "A"],
    ["A", "V", "V", "V", "V", "V", "V", "V", "V", "V", "V", "V", "V", "V", "V", "V", "V", "V", "V", "V", "V", "V", "V", "V", "V", "V", "V", "V", "V", "V", "V", "A"],
    ["A", "V", "V", "V", "V", "V", "V", "V", "V", "V", "V", "V", "V", "V", "V", "V", "V", "V", "V", "V", "V", "V", "V", "V", "V", "V", "V", "V", "V", "V", "V", "A"],
    ["A", "V", "V", "V", "V", "V", "V", "V", "V", "V", "V", "V", "V", "V", "V", "V", "V", "V", "V", "V", "V", "V", "V", "V", "V", "V", "V", "V", "V", "V", "V", "A"],
    ["A", "V", "V", "V", "V", "V", "V", "V", "V", "V", "V", "V", "V", "V", "V", "V", "V", "V", "V", "V", "V", "V", "V", "V", "V", "V", "V", "V", "V", "V", "V", "A"],
    ["A", "V", "V", "V", "V", "V", "V", "V", "V", "V", "V", "V", "V", "V", "V", "V", "V", "V", "V", "V", "V", "V", "V", "V", "V", "V", "V", "V", "V", "V", "V", "A"],
    ["A", "V", "V", "V", "V", "V", "V", "V", "V", "V", "V", "V", "V", "V", "V", "V", "V", "V", "V", "V", "V", "V", "V", "V", "V", "V", "V", "V", "V", "V", "V", "A"],
    ["A", "V", "V", "V", "V", "V", "V", "V", "V", "V", "V", "V", "V", "V", "V", "V", "V", "V", "V", "V", "V", "V", "V", "V", "V", "V", "V", "V", "V", "V", "V", "A"],
    ["A", "V", "V", "V", "V", "V", "V", "V", "V", "V", "V", "V", "V", "V", "V", "V", "V", "V", "V", "V", "V", "V", "V", "V", "V", "V", "V", "V", "V", "V", "V", "A"],
    ["E", "B", "B", "B", "B", "B", "B", "B", "B", "B", "B", "B", "B", "B", "B", "B", "B", "B", "B", "B", "B", "B", "B", "B", "B", "B", "B", "B", "B", "B", "B", "F"]

]}]

